1111111111111111111111111111111111
1E0000000000000C000E0C0000000000E1
10100101001000001010010C0000010101
1010C1001010101C001001000C00010101
1P00000E0C00C00000000000000C0000C1
1111111111111111111111111111111111
