11111111111111111111111111
1P111111111111111111111E11
11111111111111111111111111
11000100010001000010100011
11011101110101011110101011
11000100010001010010101011
11110101110011011010101011
11000100010101000010100011
11111111111111111111111111
1C111111111111111111111C11
11111111111111111111111111
