1111111111111111
1C000000000000C1
1111010101100111
1P00001C00000CE1
1111111111111111